NO textures/stone.xpm
SO textures/stone.xpm
EA textures/stone.xpm
WE textures/stone.xpm

F 125,252,0
C 135, 206, 235

111111111111111111111111111111
100000000000000001000000000001
100c0000000000000G000000000001
100000000000000001000000000001
111111111111011111111111111111
1a0000010000000001000000000001
100000010000000001000000000001
111101110000000000000000000001
100000010000000001000000000001
100000011111111011000000000001
10E000000000000001110111110111
100000011111011111100011100011
10000001000000000110001110b011
111111111111111111111111111111
