NO textures/stone.xpm
SO textures/stone.xpm
EA textures/stone.xpm
WE textures/stone.xpm

F 125,252,0
C 135, 206, 235

111111111111111111111111111111
100000000000000000000000000001
100E00000a00000b00000c00000001
100000000000000000000000000001
111111111111111111111111111111
