NO textures/wall_warning.xpm
SO textures/wall.xpm
EA textures/wall_poster.xpm
WE textures/wall.xpm

F 64,76,92
C 22, 32, 40

111111111111111111111111111111
100000000000000000000000001001
100E00000a00000b00000c0000G001
100000000000000000000000001001
111111111111111111111111111111
