NO textures/n_test.xpm
SO textures/s_test.xpm
WE textures/w_test.xpm
EA textures/e_test.xpm

F 220,100,0
C 225,30,0

11111111111111111111
10000000000000000001
10000000000000000001
11111100000000000001
     100000000000001
	 1000000N0000001
	 100000000000001
	 111111111111101
